11111111111111111
1P001111111111111
10001000001000C01
11001001001001001
11001001001001001
110010011110C1111
11C00000000000001
11001001111111111
11001000000001001
11111001111001001
11000C00001000001
11C111111111110E1
11111111111111111
