1111111111
100C000001
1P01E00C11
1001100011
1111111111
