1111111111111
1000000000011
1111011100111
10010100000C1
1000000111001
100001000C001
1P0011E000001
1111111111111
